<Map>
	Cell_Width_Height: 15 10
	Picture_Index:
		 0  0  0  0  0  0  0  0  0  0  0  0  0  0  0
		 0  0  0  0  0  0  0  0  0  0  0  0  0  0  0
		 0  0  0  0  0  0  0  0  0  0  0  0  0  0  0
		 0  0  0  0  0  0  0  0  0  0  0  0  0  0  0
		 0  0  0  0  0  0  0  0  0  0  0  0  0  0  0
		 0  0  0  0  0  0  0  0  0  0  0  0  0  0  0
		 0  0  0  0  0  0  0  0  0  0  0  0  0  0  0
		 0  0  0  0  0  0  0  0  0  0  0  0  0  0  0
		 0  0  0  0  0  0  0  0  0  0  0  0  0  0  0
		 0  0  0  0  0  0  0  0  0  0  0  0  0  0  0
	Type_Index:
		 1  1  1  1  1  1  1  1  1  1  1  1  1  1  1
		 1  1  0  0  0  0  0  0  0  0  0  0  0  1  1
		 1  1  0  0  0  0  0  0  0  0  0  0  0  1  1
		 1  1  0  0  0  0  0  0  0  0  0  0  0  1  1
		 0  0  0  0  0  0  0  0  0  0  0  0  0  0  0
		 0  0  0  0  0  0  0  0  0  0  0  0  0  0  0
		 0  0  0  0  0  0  0  0  0  0  0  0  0  0  0
		 1  3  2  0  0  0  0  0  0  0  0  0  4  5  1
		 1  1  3  2  0  0  0  0  0  0  0  4  5  1  1
		 1  1  1  1  1  1  1  1  1  1  1  1  1  1  1
#MapEnd

<Background>
	Delta_X_Y: 0 128
	Width_Height: 480 192
	Cell_Width_Height: 1 1
#BackgroundEnd