<Map>
	Cell_Width_Height: 20 20
	Picture_Index:
		29	30	29	30	29	30	29	30	29	30	29	30	29	30	29	30	29	30	29	30
		31	32	31	32	1	2	1	2	1	2	1	2	1	2	1	2	31	32	31	32
		29	30	33	27	0	0	0	0	0	0	0	0	0	0	0	0	25	32	29	30
		1	2	28	0	0	0	0	0	0	0	0	0	0	0	0	0	0	26	31	32
		0	0	0	0	0	0	0	0	0	0	0	0	0	0	0	0	0	0	29	30
		0	0	0	0	0	0	0	0	0	0	0	0	0	0	0	0	0	0	31	32
		0	0	0	0	0	0	0	0	0	0	0	0	0	0	0	0	0	0	29	30
		3	4	0	0	0	0	0	0	0	0	0	0	0	0	0	0	0	0	31	32
		29	30	0	0	0	0	0	0	0	0	0	0	0	0	0	0	0	0	29	30
		31	32	0	0	0	0	0	0	0	0	0	0	0	0	0	0	0	0	31	32
		29	30	0	0	0	0	0	0	0	0	0	0	0	0	0	0	0	0	29	30
		31	32	0	0	0	0	0	0	0	0	0	0	0	0	0	0	0	0	31	32
		29	30	0	0	0	0	0	0	0	0	0	0	0	0	0	0	0	0	29	30
		31	32	0	0	0	0	0	0	0	0	0	0	0	0	0	0	0	0	31	32
		29	30	5	6	0	0	0	0	0	0	0	0	0	0	0	0	5	6	29	30
		31	32	0	0	0	0	0	0	0	0	0	0	0	0	0	0	0	0	31	32
		29	30	0	0	0	0	0	0	0	0	0	0	0	0	0	0	0	0	29	30
		31	32	3	4	3	4	3	4	3	4	3	4	3	4	3	4	3	4	31	32
		29	30	29	30	29	30	29	30	29	30	29	30	29	30	29	30	29	30	29	30
		31	32	31	32	31	32	31	32	31	32	31	32	31	32	31	32	31	32	31	32
	Type_Index:
		1	1	1	1	1	1	1	1	1	1	1	1	1	1	1	1	1	1	1	1
		1	1	1	1	1	1	1	1	1	1	1	1	1	1	1	1	1	1	1	1
		1	1	1	1	0	0	0	0	0	0	0	0	0	0	0	0	1	1	1	1
		1	1	1	0	0	0	0	0	0	0	0	0	0	0	0	0	0	1	1	1
		0	0	0	0	0	0	0	0	0	0	0	0	0	0	0	0	0	0	1	1
		0	0	0	0	0	0	0	0	0	0	0	0	0	0	0	0	0	0	1	1
		0	0	0	0	0	0	0	0	0	0	0	0	0	0	0	0	0	0	1	1
		1	1	0	0	0	0	0	0	0	0	0	0	0	0	0	0	0	0	1	1
		1	1	0	0	0	0	0	0	0	0	0	0	0	0	0	0	0	0	1	1
		1	1	0	0	0	0	0	0	0	0	0	0	0	0	0	0	0	0	1	1
		1	1	0	0	0	0	0	0	0	0	0	0	0	0	0	0	0	0	1	1
		1	1	0	0	0	0	0	0	0	0	0	0	0	0	0	0	0	0	1	1
		1	1	0	0	0	0	0	0	0	0	0	0	0	0	0	0	0	0	1	1
		1	1	0	0	0	0	0	0	0	0	0	0	0	0	0	0	0	0	1	1
		1	1	6	6	0	0	0	0	0	0	0	0	0	0	0	0	6	6	1	1
		1	1	0	0	0	0	0	0	0	0	0	0	0	0	0	0	0	0	1	1
		1	1	0	0	0	0	0	0	0	0	0	0	0	0	0	0	0	0	1	1
		1	1	1	1	1	1	1	1	1	1	1	1	1	1	1	1	1	1	1	1
		1	1	1	1	1	1	1	1	1	1	1	1	1	1	1	1	1	1	1	1
		1	1	1	1	1	1	1	1	1	1	1	1	1	1	1	1	1	1	1	1

#MapEnd

<Background>
	Delta_X_Y: 0 32
	Width_Height: 288 256
	Cell_Width_Height: 2 2
#BackgroundEnd