<Map>
	Cell_Width_Height: 32 26
	Picture_Index:
		29 30 15 16 15 16 15 16 15 16 15 16 15 16 15 16 15 16 15 16 15 16 15 16 15 16 15 16 15 16 29 30
		31 32  0  0  0  0  0  0  0  0  0  0  0  0  0  0  0  0  0  0  0  0  0  0  0  0  0  0  0  0 31 32
		29 30  0  0  0  0  0  0  0  0  0  0  0  0  0  0  0  0  0  0  0  0  0  0  0  0  0  0  0  0 29 30
		17 18  9 10  0  0  0  0  0  0  0  0  0  8  3  4  3  4  7  0  0  0  0  0  0  0  0  0 11 12 17 18
		 0  0  0  0  0  0  0  0  0  0  0  0  8 22 29 30 29 30 19  7  0  0  0  0  0  0  0  0  0  0  0  0
		 0  0  0  0  0  0  0  0  0  0  0  8 23 32 31 32 31 32 31 20  7  0  0  0  0  0  0  0  0  0  0  0
		 0  0  0  0  0  0  0  0  0  0  0 22 29 30 29 30 29 30 29 30 19  7  0  0  0  0  0  0  0  0  0  0
		 3  4  3  4  7  0  0  0  0  0  0 26  1  2 31 32 31 32  1  2  1  2 13  0  0  0  0  8  3  4  3  4
		29 30 29 30 19  7  0  0  0  0  0  0  0  0 29 30 29 30  0  0  0  0  0  0  0  0  8 22 29 30 29 30
		31 32  1  2 31 21  7  0  0  0  0  0  0  0 31 32 31 32  0  0  0  0  0  0  0  8 24 34  1  2 31 32
		29 30  0  0 25 32 19  7  0  0  0  0  0  0 29 30 29 30  0  0  0  0  0  0  8 22 33 27  0  0 29 30
		31 32  0  0  0 26  1  2 13  0  0  0  0  0 31 32 31 32  0  0  0  0  0 14  1  2 28  0  0  0 31 32
		29 30  0  0  0  0  0  0  0  0  0  0  0  0 29 30 29 30  0  0  0  0  0  0  0  0  0  0  0  0 29 30
		31 32  0  0  0  0  0  0  0  0  0  8  3  4 31 32 31 32  3  4  7  0  0  0  0  0  0  0  0  0 31 32
		29 30  0  0  0  0  0  0  0  0  8 22 29 30 29 30 29 30 29 30 19  7  0  0  0  0  0  0  0  0 29 30
		31 32  0  0  0  0  0  0  0  8 24 34  1  2  1  2  1  2  1  2 31 21  7  0  0  0  0  0  0  0 31 32
		29 30  0  0  0  0  0  0  8 22 33 27  0  0  0  0  0  0  0  0 25 32 19  7  0  0  0  0  0  0 29 30
		31 32  0  0  0  0 13 14  1  2 28  0  0  0  0  0  0  0  0  0  0 26  1  2 13 14  0  0  0  0 31 32
		29 30  0  0  0  0  0  0  0  0  0  0  0  0  0  0  0  0  0  0  0  0  0  0  0  0  0  0  5  6 29 30
		31 32  9 10  0  0  0  0  0  0  0  0  0  0  0  0  0  0  0  0  0  0  0  0  0  0  0  0  0  0 31 32
		29 30  0  0  0  0  0  0  0  0  0  0  0  0  0  0  0  0  0  0  0  0  0  0  0  0  0  0  0  0 29 30
		17 18  0  0  0  8  3  4  0  0  5  6  5  6  5  6  5  6  5  6  5  6  0  0  8  4  3  4  0  0 17 18
		 0  0  0  0  8 22 29 30  0  0  0  0  0  0  0  0  0  0  0  0  0  0  0  0 22 30 29 30  0  0  0  0
		 3  4  3  4 23 32 31 32  0  0  0  0  0  0  0  0  0  0  0  0  0  0  0  0 31 32 31 32  3  4  3  4
		29 30 29 30 29 30 29 30  0  0  0  0  0  0  0  0  0  0  0  0  0  0  0  0 29 30 29 30 29 30 29 30
		31 32 31 32 31 32 31 32  3  4  3  4  3  4  3  4  3  4  3  4  3  4  3  4 31 32 31 32 31 32 31 32
	Type_Index:
		 1  1  1  1  1  1  1  1  1  1  1  1  1  1  1  1  1  1  1  1  1  1  1  1  1  1  1  1  1  1  1  1
		 1  1  0  0  0  0  0  0  0  0  0  0  0  0  0  0  0  0  0  0  0  0  0  0  0  0  0  0  0  0  1  1
		 1  1  0  0  0  0  0  0  0  0  0  0  0  0  0  0  0  0  0  0  0  0  0  0  0  0  0  0  0  0  1  1
		 1  1  1  1  0  0  0  0  0  0  0  0  0  4  5  1  1  3  2  0  0  0  0  0  0  0  0  0  1  1  1  1
		 0  0  0  0  0  0  0  0  0  0  0  0  4  5  1  1  1  1  3  2  0  0  0  0  0  0  0  0  0  0  0  0
		 0  0  0  0  0  0  0  0  0  0  0  4  5  4  1  1  1  1  1  3  2  0  0  0  0  0  0  0  0  0  0  0
		 0  0  0  0  0  0  0  0  0  0  0  1  1  1  1  1  1  1  1  1  3  2  0  0  0  0  0  0  0  0  0  0
		 1  1  1  3  2  0  0  0  0  0  0  1  1  1  1  1  1  1  1  1  1  1  1  0  0  0  0  4  5  1  1  1
		 1  1  1  1  3  2  0  0  0  0  0  0  0  0  1  1  1  1  0  0  0  0  0  0  0  0  4  5  1  1  1  1
		 1  1  1  1  1  3  2  0  0  0  0  0  0  0  1  1  1  1  0  0  0  0  0  0  0  4  5  1  1  1  1  1
		 1  1  0  0  1  1  3  2  0  0  0  0  0  0  1  1  1  1  0  0  0  0  0  0  4  5  1  1  0  0  1  1
		 1  1  0  0  0  1  1  1  1  0  0  0  0  0  1  1  1  1  0  0  0  0  0  1  1  1  1  0  0  0  1  1
		 1  1  0  0  0  0  0  0  0  0  0  0  0  0  1  1  1  1  0  0  0  0  0  0  0  0  0  0  0  0  1  1
		 1  1  0  0  0  0  0  0  0  0  0  4  5  1  1  1  1  1  1  3  2  0  0  0  0  0  0  0  0  0  1  1
		 1  1  0  0  0  0  0  0  0  0  4  5  1  1  1  1  1  1  1  1  3  2  0  0  0  0  0  0  0  0  1  1
		 1  1  0  0  0  0  0  0  0  4  5  1  1  1  1  1  1  1  1  1  1  3  2  0  0  0  0  0  0  0  1  1
		 1  1  0  0  0  0  0  0  4  5  1  1  0  0  0  0  0  0  0  0  1  1  3  2  0  0  0  0  0  0  1  1
		 1  1  0  0  0  0  1  1  1  1  1  0  0  0  0  0  0  0  0  0  0  1  1  1  1  1  0  0  0  0  1  1
		 1  1  0  0  0  0  0  0  0  0  0  0  0  0  0  0  0  0  0  0  0  0  0  0  0  0  0  0  6  6  1  1
		 1  1  1  1  0  0  0  0  0  0  0  0  0  0  0  0  0  0  0  0  0  0  0  0  0  0  0  0  0  0  1  1
		 1  1  0  0  0  0  0  0  0  0  0  0  0  0  0  0  0  0  0  0  0  0  0  0  0  0  0  0  0  0  1  1
		 1  1  0  0  0  4  5  1  0  0  6  6  6  6  6  6  6  6  6  6  6  6  0  0  4  5  1  1  0  0  1  1
		 1  1  0  0  4  5  1  1  0  0  0  0  0  0  0  0  0  0  0  0  0  0  0  0  5  1  1  1  0  0  1  1
		 1  1  1  1  1  1  1  1  0  0  0  0  0  0  0  0  0  0  0  0  0  0  0  0  1  1  1  1  1  1  1  1
		 1  1  1  1  1  1  1  1  0  0  0  0  0  0  0  0  0  0  0  0  0  0  0  0  1  1  1  1  1  1  1  1
		 1  1  1  1  1  1  1  1  1  1  1  1  1  1  1  1  1  1  1  1  1  1  1  1  1  1  1  1  1  1  1  1
#MapEnd

<Background>
	Delta_X_Y: 0 32
	Width_Height: 256 256
	Cell_Width_Height: 4 3
#BackgroundEnd